##############
#   #  ####  #
# ####  ##  # 
#   #  ##  #  
### # ##  #   
#        #    
#### ####     